NO ./xpm/clouds.xpm
SO ./xpm/fire-skull.xpm
WE ./xpm/nightmare-galloping.xpm
EA ./xpm/clouds.xpm

C 255,72,145
F 254,150,24

        11111111111111111111111111111111111111111111111111
        1000000000110000000000000000000001100000000000001
        101100000111000000000000000000000110000000000001
        10010000000000000000000001100000111000000000001
11111111101100000111000000000000001000000000000000000001
100000000011000001110111111111111011000001110000000000001
111101111111110111000000100011000000000110000011101111111111
11110111111111011101010010000000000111111111011100000010001
1100000011010101110000001000111110111111111011101010010001
1000000000000000110000001000111000000110101011100000010001
1000000000000000110101001000010000000000000001100000010001
11000001110101011111011110N011110000000000000000010100100111
11110111 1110101 101111010000110000011101010111110111100111
11111111 1111111 11111111111111110111 1110101 101111010001
11111111 1111111 11111111111111111111 1111111 111111111111